##############
#............#
#............#
#0...........#
##############
0
Яма