##############
#...........0#
#............#
#............#
##############
0